abramovich -> a bờ ra mô vích
acid -> a xít
ak -> a ca
album -> an bum
alex -> a lếc
algeria -> an dê ri a
amiđan -> a mi dan
amino -> a mi no
analytics -> an na lít tíc
ancelotti -> an xê lốt ti
angola -> ăng go la
anna -> an na
annan -> an nan
aoki -> ao ki
apple -> áp pồ
april -> ây pờ rồ
arsenal -> át xê nan
australia -> ốt trây li a
avramovic -> a vờ ra mô vích
baggio -> bát dô
bangkok -> băng cốc
barca -> mác xa
barcelona -> mác xe đô na
bauxit -> bâu xít
belarus -> ben la rút
bergkamp -> bếc khăm
beta -> bê ta
big -> bích
bigc -> bích c
blatter -> bờ lát tơ
blogger -> bờ lốc gơ
blues -> bờ lu
bolton -> bót tơn
boong -> bong
brâu -> bờ râu
bravo -> bờ ra vồ
bundesliga -> bun dét li ga
bush -> bút
calisto -> ca lít tô
cameroon -> ca mô run 
campuchia -> căm phu chia
canada -> ca na da
cannon -> ca nông
carrick -> ca rích
cech -> chếc
check -> chếc
chelsea -> chen xi
click -> cờ lích
clinton -> cờ lin tơn
cocktail -> cốc tai
colleen -> cô lin
colombia -> cô lôm bi a
composer -> com pâu sờ
crai -> cờ rai
croatia -> cờ roát ti a
cuba -> cu ba
đắk -> đắc
dante -> dan ti
david -> đa vít
dell -> đeo
delta -> den ta
desktop -> dét tóp
drogba -> đờ róc ba
ecuador -> ê cu a đo
ellen -> y len
email -> y meo
emily -> em mi ly
estrogen -> ét tro ghen
eu -> e u
euro -> ơ rô
everton -> e vơ tơn
evn -> y vi en
excel -> x xeo
express -> x pờ rét
gallery -> ga lơ ri
game -> gêm
games -> gêm
gas -> ga
gerrard -> de ra
google -> gu gờ
group -> gờ rúp
hacker -> hách cờ
harvard -> ha vớt
heroin -> hê rô in
hip -> híp
hiphop -> híp hóp
honduras -> hôn đô rát
hongkong -> hông công
hormone -> hóc môn
hotdog -> hót đóc
hugo -> hy go
hungari -> hung ga ri
hyđrô -> hin đờ rô
indonesia -> in đô nê xi a
inox -> i nốc
intel -> in theo
inter -> in tơ
internet -> in tơ nét
iốt -> i ốt
iphone -> ai phôn
iran -> i ran
iraq -> i rắc
israel -> ít xa ren
italia -> i ta li a
italy -> i ta ly
kaka -> ka ka
kan -> can
karaoke -> ka ra o ke
lampard -> lam pác
laser -> la de
lenovo -> lê nô vô
lippi -> líp pi
liverpool -> li vơ phun
logitech -> lô git tếch
london -> luân đôn
lyon -> ly ông
malaysia -> ma lai si a
maradona -> ma ra đô na
maria -> ma ri a
mark -> mát
marketing -> ma kết tinh
massage -> mát xa
mc -> em xi
mexico -> mê xi cô
micro -> mi cờ rô
mikel -> mi ken
milan -> mi lan
mini -> mi ni
mocktail -> mốc tai
moldova -> môn đô va
mourinho -> mô di nhô
mr -> mít tờ
myanmar -> miên an ma
nano -> na no
neon -> nê on
nepal -> nê phan
nigeria -> ni dê ri a
nilông -> ni lông
nokia -> nô ki a
nxb -> nhà xuất bản
nylon -> ny lon
olympic -> ô ly phích
organ -> óc gan
oxy -> ô xi
pakistan -> pa kít tan
palestine -> pa lét tin
panama -> pa na ma
paralympic -> pa ra ly phích
paris -> pa rít
party -> pát ty
pele -> pê lê
pen -> pen
pet -> pét
pét -> pét
petrolimex -> pê trô li mếc
philippines -> pi líp phin
phnôm -> phờ nôm
phone -> phôn
photocopy -> pô tô cóp py
piano -> pi a no
pixel -> píc xeo
plalini -> pờ lan li ni
plasma -> pờ lát ma
playhouse -> pờ lây hau
pleiku -> pờ lây cu
pơmu -> pơ mu
pop -> póp
protein -> pờ rô tê in
putin -> pút tin
pvc -> pi vi xi
reading -> rít đinh
real -> rít
ronaldinho -> rô nan đi nhô
ronaldo -> rô nan đô
rooney -> run ny
salon -> xa lông
samsung -> sam sung
scolari -> sờ cô la ri
seoul -> xe un
sharapova -> xa ra pô va
shevchenko -> séc chen cô
shop -> sóp
silicone -> xi li côn
simon -> si mân
singapore -> xinh ga pho
slogan -> sờ lâu gân
sôcôla -> sô cô la
sony -> son ny
southampton -> sao tham tơn
spam -> sờ pham
stoke -> sờ tốc
stress -> sờ trét
taxi -> tắc xi
techcombank -> tếch com banh
tennis -> te nít
thailand -> thái lan
thinkpad -> thinh pác
titan -> ti tan
tivi -> ti vi
toshiba -> tô si ba
tottenham -> tốt ten ham
tour -> tua
trailer -> trai lờ
ukraine -> u cờ rai na
uruguay -> u ru quay
văcxin -> vắc xin
vedan -> vê dan
video -> vi deo
vietravel -> việt tra vờ
viettel -> việt theo
viglacera -> vi la xê ra
vinaphone -> vi na phôn
virus -> vi rút
vitamin -> vi ta min
xêri -> xê ri
xoong -> xoong
yahoo -> da hu
yoga -> dô ga
crowne -> cờ rao
plaza -> pờ la da
ok -> ô kê
alo -> a lô
a -> anh
e -> em
b -> bê
c -> xê
d -> đê
f -> ép
g -> gờ
h -> hát
j -> di
k -> ca
l -> lờ
m -> mờ
n -> nờ
p -> pê
q -> quy
r -> rờ
s -> ét
t -> tê
w -> dáp liu
x -> ích
z -> dét
facebook -> phây búc
google -> gu gờ
wifi -> goai phai
youtube -> diu tút
dropbox -> đờ róp bóc
zalo -> da lô